EA textures/wolfenstein/red_brick.xpm
NO textures/wolfenstein/red_brick.xpm
SO textures/wolfenstein/red_brick.xpm
WE textures/wolfenstein/red_brick.xpm

C 22,14,5
F 100,42,12


111111111111111
11111100011111111111111111111111
111110000011111111111
111100000001111111111111111
11100000000011111111
11000000000001111111111111
100001111100001111111111
110000111000011111111111
1110000100001111
11110000001111111
11111000001111111
10000N0000000001
1000000000000001
1111111111111111