EA /home/youssef/Desktop/cub3D
NO /home/youssef/Desktop/cub3D
SO /home/youssef/Desktop/cub3D
WE /home/youssef/Desktop/cub3D

C 22,14,5
F 100,42,12


111111111111111
11111100011111111111111111111111
111110000011111111111
1111000N0001111111111111111
11100000000011111111
11000000000001111111111111
100001111100001111111111
110000111000011111111111
1110000100001111
11110000001111111
11111000001111111
111111000111111
1111111111111111
