NO textures/simonkraft/respawn_anchor_side0.xpm
EA textures/simonkraft/respawn_anchor_side2.xpm
SO textures/simonkraft/respawn_anchor_side4.xpm
WE textures/simonkraft/respawn_anchor_side3.xpm

C 35,19,73
F 15,6,40

111111111111111
111111XXX1111XX
111111XXX111XX1
111111XXX111X11
11111XXXXX1XX11
1111XXXNXXXX111
111XXXXXXXXX111
11XXXXXXXXXXXXXXXXXX11
1XXXX11111XXXX1
11XXXX111XXXX11
XXXXXXX1XXXX111
111XXXXXXX1111
11111XXXXX11111
111111XXX111111
111111111111111

