

NO 		textures/matrix.xpm
SO 	textures/matrix.xpm
WE   textures/matrix.xpm
	EA textures/matrix.xpm

		F 0,0,10
C 	0,	0,0

111111111111111111111
111111111111111111111
111111111111111111111
111111111111111111111
111111111111111111111
111111111111111111111
111111111111111111111
111111111111111111111
1111111111111111111111111111111
1111111111111111111111111111101
1111111111111111111111111111111
111111111111111111111
111111111111111111111
11111111111N111111111
111111111111111111111
111111111111111111111
111111111111111111111
111111111111111111111
111111111111111111111
111111111111111111111
111111111111111111111
111111111111111111111
