

NO 		textures/matrix.xpm
SO 	textures/matrix.xpm
WE   textures/matrix.xpm
	EA textures/matrix.xpm

		F 0,0,10
C 	0,	0,0

111111111111111111111
111111111111111111111
111111111111111111111
111111111111111111111
111111111111111111111
111111111111111111111
111111111111111111111
111111111111111111111111111111111111111111111111
1111111111111111111111111111111111111111111111E1111
111111111111111111111111111111111111111111111111
111111111111  111111111111111111111111111111
1111111111   11111111111
11111111  1111111111111
111111  11111111111111
111111111111111111111
111111111111111111111
11111111111111111111
111111111111111111111
111111111111111111111
111111111111111111111
111111111111111111111
1111 11111111111111111



