111111111 00000z
000000000000z
5555555555z5z
000000000008z
00000000z

1111111111111
111111111



1111111
11111111