NO sdfsf
WE
SO
EA
c      NO asdfasdf
f
c

ndkjfsadjfkj

                        11111
                        11111111111111
                        111110
